"team_h_last_w","team_h_last_dr","team_h_last_de","team_a_last_w","team_a_last_dr","team_a_last_de","team_h_form_last_3","team_a_form_last_3","form_delta_last_3","team_h_form_last_5","team_a_form_last_5","form_delta_last_5","team_h_form_last_10","team_a_form_last_10","form_delta_last_10","team_h_win_perc","team_h_dra_perc","team_h_def_perc","team_a_win_perc","team_a_dra_perc","team_a_def_perc","tm_pred","tm_pred_p","team_value_ratio","avg_pl_value_ratio","a_int_delta","winner"
2,6,1,6,2,1,4,1,3,5,2,3,10,7,3,0.5,0,0.5,0,0.25,0.75,"H",0.63,0.8,0.72,-2,"H"
2,1,6,1,3,2,4,3,1,7,6,1,12,11,1,0.5,0.5,0,0.5,0.25,0.25,"H",0.95,2.62,2.81,0,"H"
1,6,2,1,3,4,4,5,-1,5,6,-1,10,11,-1,0.5,0,0.5,0.5,0.25,0.25,"A",0.47,0.78,0.8,-4,"X"
1,3,4,2,1,3,5,3,2,6,6,0,11,11,0,0.5,0.25,0.25,0.5,0.25,0.25,"H",0.77,1.84,1.32,1,"A"
2,3,1,6,6,1,3,0,3,6,1,5,11,6,5,0.5,0.25,0.25,0,0,1,"H",0.45,0.38,0.46,0,"H"
1,2,6,1,6,6,4,6,-2,6,9,-3,11,14,-3,0.25,0.75,0,1,0,0,"A",0.98,0.04,0.04,-12,"A"
6,6,1,1,3,2,0,3,-3,1,6,-5,6,11,-5,0,0,1,0.5,0.25,0.25,"A",0.62,0.37,0.38,-1,"A"
1,6,6,3,6,1,6,2,4,9,5,4,14,10,4,1,0,0,0.5,0,0.5,"H",0.78,1.5,1.68,4,"H"
6,3,1,6,4,1,1,0,1,2,2,0,7,7,0,0,0.25,0.75,0,0.25,0.75,"H",0.69,1.05,0.94,-2,"H"
1,7,7,1,2,7,6,5,1,10,8,2,15,13,2,1,0,0,0.6,0.4,0,"H",0.85,3.16,3.4,5,"H"
2,4,1,1,4,2,2,4,-2,5,7,-2,10,12,-2,0.4,0.2,0.4,0.6,0.2,0.2,"A",0.34,1.12,0.82,2,"H"
1,2,4,2,1,3,5,3,2,7,5,2,12,10,2,0.6,0.2,0.2,0.4,0.2,0.4,"H",0.41,0.55,0.66,1,"A"
2,3,1,2,4,1,3,4,-1,5,5,0,10,10,0,0.2,0.6,0.2,0.4,0.2,0.4,"A",0.4,0.41,0.48,-6,"H"
1,4,3,2,1,5,4,5,-1,7,6,1,12,11,1,0.6,0.2,0.2,0.4,0.4,0.2,"H",0.7,2.62,2.9,-1,"H"
4,7,1,1,7,2,0,4,-4,4,6,-2,9,11,-2,0.4,0,0.6,0.6,0,0.4,"H",0.82,3.12,3.48,3,"H"
7,7,1,1,4,2,0,2,-2,0,3,-3,5,8,-3,0,0,1,0.2,0.2,0.6,"H",0.59,2.84,3.79,0,"H"
7,5,1,7,7,1,0,0,0,1,0,1,6,5,1,0,0.2,0.8,0,0,1,"A",0.48,0.75,0.64,1,"A"
7,3,1,1,7,7,1,6,-5,1,10,-9,6,15,-9,0,0.2,0.8,1,0,0,"A",0.94,0.27,0.24,-5,"X"
2,5,1,2,3,1,2,3,-1,5,5,0,11,11,0,0.5,0.17,0.33,0.5,0.17,0.33,"H",0.66,1.92,2.18,0,"X"
2,3,1,8,6,1,3,0,3,6,0,6,12,5,7,0.5,0.33,0.17,0,0.17,0.83,"H",0.98,3.28,3.76,0,"X"
1,8,2,1,8,2,2,2,0,2,2,0,6,6,0,0.17,0,0.83,0.17,0,0.83,"A",0.41,0.44,0.44,1,"A"
2,5,1,8,1,2,2,1,1,3,2,1,7,6,1,0.17,0.17,0.67,0,0.33,0.67,"H",0.58,0.69,0.52,-1,"A"
3,5,1,1,8,2,2,2,0,5,4,1,9,10,-1,0.33,0.17,0.5,0.5,0,0.5,"A",0.65,0.28,0.22,-1,"A"
2,8,1,1,8,8,2,6,-4,6,10,-4,10,16,-6,0.5,0,0.5,1,0,0,"A",0.97,0.12,0.1,-8,"A"
1,2,4,1,5,4,5,6,-1,7,7,0,11,13,-2,0.5,0.17,0.33,0.67,0.17,0.17,"A",0.53,0.3,0.28,-3,"A"
3,2,1,1,5,2,3,4,-1,6,5,1,10,11,-1,0.33,0.33,0.33,0.5,0.17,0.33,"H",0.76,1.09,1.06,1,"X"
2,1,8,1,4,2,5,4,1,9,6,3,15,11,4,0.83,0.17,0,0.33,0.5,0.17,"H",0.98,12.94,16.17,11,"X"
1,9,9,3,1,9,6,4,2,10,8,2,17,15,2,1,0,0,0.71,0.29,0,"H",0.79,1.83,1.69,1,"H"
1,6,5,3,1,2,6,3,3,8,5,3,14,11,3,0.71,0.14,0.14,0.43,0.29,0.29,"H",0.9,3.2,2.51,2,"A"
1,9,3,3,6,1,4,2,2,4,2,2,11,6,5,0.57,0,0.43,0.14,0.14,0.71,"H",0.95,3.6,4.8,2,"X"
1,9,3,3,1,2,4,3,1,4,6,-2,7,12,-5,0.29,0,0.71,0.43,0.43,0.14,"A",0.4,0.91,0.94,-2,"H"
9,1,2,4,6,1,1,0,1,1,4,-3,5,8,-3,0,0.29,0.71,0.29,0.14,0.57,"A",0.49,0.93,1.02,1,"H"
2,1,3,2,3,1,3,3,0,5,5,0,11,10,1,0.43,0.29,0.29,0.43,0.14,0.43,"H",0.56,1.18,1.18,3,"H"
1,2,3,2,9,1,3,2,1,4,2,2,7,5,2,0.14,0.29,0.57,0.14,0,0.86,"H",0.58,1.14,1.14,0,"X"
3,1,2,4,1,2,3,2,1,6,6,0,11,10,1,0.43,0.29,0.29,0.29,0.43,0.29,"A",0.45,0.43,0.53,-3,"H"
2,1,3,3,9,1,3,2,1,6,4,2,11,9,2,0.29,0.57,0.14,0.43,0,0.57,"X",0.4,0.36,0.36,-4,"A"
2,7,1,1,2,4,4,5,-1,8,7,1,13,12,1,0.63,0.13,0.25,0.5,0.25,0.25,"H",0.83,2.86,3.06,0,"H"
4,2,1,2,1,4,1,4,-3,4,4,0,11,7,4,0.38,0.38,0.25,0.13,0.38,0.5,"H",0.89,2.17,2.09,1,"H"
3,4,1,2,1,4,2,5,-3,5,5,0,9,11,-2,0.38,0.13,0.5,0.5,0.13,0.38,"A",0.74,0.28,0.25,-3,"X"
3,1,2,1,2,3,3,3,0,3,6,-3,5,12,-7,0.13,0.13,0.75,0.5,0.25,0.25,"H",0.55,2.27,2.11,1,"H"
4,1,2,3,2,1,1,3,-2,3,5,-2,6,10,-4,0.13,0.25,0.63,0.25,0.5,0.25,"H",0.58,2.4,2,5,"A"
5,7,1,1,10,10,0,6,-6,2,10,-8,7,18,-11,0.25,0.13,0.63,1,0,0,"A",0.98,0.1,0.08,-6,"A"
5,2,1,1,10,4,1,6,-5,4,6,-2,9,8,1,0.25,0.38,0.38,0.38,0,0.63,"A",0.46,0.46,0.4,3,"A"
1,2,3,1,2,3,3,3,0,5,3,2,12,6,6,0.5,0.25,0.25,0.13,0.25,0.63,"H",0.84,1.12,1.63,-2,"A"
1,10,2,4,2,1,2,2,0,4,6,-2,10,14,-4,0.5,0,0.5,0.63,0.25,0.13,"A",0.84,0.21,0.17,-7,"A"
1,11,11,2,3,1,6,3,3,10,5,5,19,11,8,1,0,0,0.44,0.22,0.33,"H",0.97,9.26,7.83,7,"H"
1,3,2,5,2,1,3,1,2,6,3,3,15,5,10,0.67,0.22,0.11,0.11,0.22,0.67,"H",0.98,5.38,8.07,6,"H"
3,1,5,1,2,3,4,3,1,6,5,1,11,6,5,0.44,0.22,0.33,0.22,0.11,0.67,"H",0.89,2.85,2.85,1,"H"
1,11,5,1,8,2,6,4,2,8,8,0,9,14,-5,0.44,0,0.56,0.67,0.11,0.22,"H",0.64,0.83,0.86,-2,"H"
1,3,4,6,3,1,5,1,4,5,2,3,7,8,-1,0.22,0.22,0.56,0.22,0.33,0.44,"X",0.37,0.73,0.71,-1,"A"
3,2,1,4,1,2,3,1,2,4,4,0,6,9,-3,0.11,0.33,0.56,0.33,0.22,0.44,"H",0.58,1.42,1.58,2,"A"
2,11,1,6,8,1,2,0,2,4,0,4,9,6,3,0.44,0,0.56,0.22,0.11,0.67,"H",0.71,1.13,1.32,-2,"A"
2,3,1,2,3,1,3,3,0,5,5,0,11,11,0,0.44,0.22,0.33,0.44,0.22,0.33,"X",0.4,0.47,0.56,-2,"A"
1,3,2,1,3,2,3,3,0,5,5,0,11,12,-1,0.33,0.44,0.22,0.44,0.33,0.22,"A",0.82,0.13,0.12,-7,"A"
2,9,1,3,4,1,2,2,0,6,3,3,13,10,3,0.6,0.1,0.3,0.4,0.2,0.4,"H",0.88,6.13,5.49,2,"X"
1,4,3,1,2,6,4,4,0,5,8,-3,13,12,1,0.5,0.3,0.2,0.5,0.2,0.3,"H",0.53,0.87,0.84,0,"H"
1,2,3,2,4,1,3,4,-1,5,5,0,10,6,4,0.4,0.2,0.4,0.2,0.2,0.6,"H",0.78,1.06,1.14,-3,"A"
2,3,1,2,4,1,3,2,1,5,5,0,5,10,-5,0.2,0.1,0.7,0.3,0.4,0.3,"H",0.64,3.03,3.37,6,"H"
6,3,1,3,12,1,1,2,-1,1,2,-1,4,8,-4,0.1,0.2,0.7,0.4,0,0.6,"H",0.5,0.87,0.72,1,"X"
1,9,2,1,4,3,2,4,-2,2,6,-4,7,16,-9,0.3,0.1,0.6,0.7,0.2,0.1,"A",0.92,0.19,0.13,-5,"A"
1,4,2,1,12,12,2,6,-4,3,10,-7,9,20,-11,0.3,0.3,0.4,1,0,0,"A",0.98,0.13,0.11,-4,"X"
3,4,1,4,3,1,2,1,1,3,4,-1,10,5,5,0.4,0.2,0.4,0.1,0.3,0.6,"H",0.57,0.74,0.91,-1,"X"
1,4,2,1,12,6,4,6,-2,7,10,-3,12,10,2,0.5,0.2,0.3,0.5,0,0.5,"A",0.72,0.42,0.38,2,"A"
2,1,13,1,4,2,5,4,1,9,5,4,19,7,12,0.91,0.09,0,0.27,0.09,0.64,"H",0.99,7.82,8.12,6,"H"
1,5,4,3,1,2,6,3,3,7,5,2,16,12,4,0.73,0.18,0.09,0.55,0.18,0.27,"H",0.91,1.58,1.84,4,"H"
2,3,1,4,1,2,3,1,2,6,4,2,10,9,1,0.45,0.18,0.36,0.36,0.27,0.36,"H",0.84,3.38,2.75,2,"A"
1,13,7,4,1,2,6,1,5,10,4,6,12,9,3,0.55,0,0.45,0.36,0.27,0.36,"H",0.95,5.11,4.75,0,"X"
7,1,2,2,10,1,1,2,-1,2,2,0,5,7,-2,0.09,0.27,0.64,0.27,0.09,0.64,"H",0.5,0.98,0.95,-1,"A"
1,5,2,2,5,1,4,2,2,7,5,2,7,10,-3,0.27,0.18,0.55,0.45,0.18,0.36,"A",0.36,0.8,0.75,0,"A"
5,1,2,2,1,3,1,3,-2,4,4,0,6,10,-4,0.09,0.36,0.55,0.27,0.36,0.36,"H",0.47,1.11,1.27,-2,"X"
4,1,2,1,5,4,1,6,-5,3,7,-4,9,13,-4,0.36,0.09,0.55,0.55,0.27,0.18,"A",0.78,0.37,0.34,-3,"H"
3,5,1,2,3,1,2,3,-1,3,3,0,9,10,-1,0.27,0.36,0.36,0.36,0.18,0.45,"X",0.38,0.41,0.41,-4,"X"
4,2,1,1,2,14,1,5,-4,3,9,-6,11,19,-8,0.5,0.17,0.33,0.92,0.08,0,"A",0.92,0.35,0.32,-5,"A"
2,1,8,2,6,1,5,2,3,9,6,3,13,7,6,0.5,0.08,0.42,0.25,0.17,0.58,"H",0.97,2.99,3.55,-2,"H"
2,6,1,1,11,2,4,4,0,6,4,2,12,8,4,0.5,0.25,0.25,0.33,0.08,0.58,"H",0.9,3.06,3.82,1,"H"
3,1,2,1,6,5,3,6,-3,4,8,-4,9,16,-7,0.33,0.25,0.42,0.75,0.17,0.08,"A",0.92,0.19,0.15,-7,"H"
2,5,1,8,2,1,2,1,1,5,2,3,7,4,3,0.25,0.08,0.67,0.08,0.25,0.67,"H",0.7,1.26,1.68,1,"A"
3,1,4,3,4,1,4,2,2,4,4,0,10,8,2,0.25,0.42,0.33,0.42,0.17,0.42,"A",0.65,0.36,0.31,1,"A"
1,2,3,1,2,3,3,3,0,5,5,0,10,9,1,0.42,0.25,0.33,0.42,0.08,0.5,"H",0.64,0.92,1.26,1,"X"
1,6,2,6,1,3,4,2,2,6,3,3,11,7,4,0.5,0.17,0.33,0.08,0.42,0.5,"H",0.73,0.83,0.74,1,"H"
5,1,3,4,1,2,2,1,1,4,3,1,10,9,1,0.33,0.33,0.33,0.25,0.42,0.33,"X",0.5,1.34,1.6,5,"H"